灯笼鱼也叫灯眼鱼，是一类身体能发光的小型鱼类。灯笼鱼身体上的发光器官起源于_____。<br>来源：《十万个为什么》（第六版）（上海世纪出版股份有限公司少年儿童出版社2014年版）|皮肤|眼睛	A	无解释
蜜蜂传粉浪费花粉少，要比风媒传粉的效率_____得多。<br>来源：《十万个为什么》（第六版）（上海世纪出版股份有限公司少年儿童出版社2014年版）|高|低	A	无解释
清除被褥里的螨虫，除了定时清洗床单、被套外，经常晒被子和褥子是最好的办法，因为阳光中的_____可将螨虫杀死。<br>来源：《十万个为什么》(第六版）（上海世纪出版股份有限公司少年儿童出版社2014年版）|紫外线|红外线	A	无解释
蛾子和蝴蝶都是鳞翅目昆虫，外形很相似。其中，_____一般身体纤细，体毛少，翅膀上常有多种色彩。<br>来源：《十万个为什么》（第六版）（上海世纪出版股份有限公司少年儿童出版社2014年版）|蛾子|蝴蝶	B	无解释
随着水利发电的兴起，电站、水库在很多地方建成。在修建这些工程的时候，会考虑到专门为鱼类设计无障碍通道，以供它们畅游通过。<br>来源：《十万个为什么》（第六版）（上海世纪出版股份有限公司少年儿童出版社2014年版）|正确|错误	A	无解释
鲨鱼的牙齿不是永久齿，只有固定的一排，这种说法是_____的。<br>来源：《十万个为什么》（第六版）(上海世纪出版股份有限公司少年儿童出版社2014年版）|正确|错误	B	无解释
在显微镜下，蝴蝶翅膀上的鳞片犹如屋顶上的瓦片一样，_____地排列着。<br>来源：《十万个为什么》（第六版）（上海世纪出版股份有限公司少年儿童出版社2014年版）|有序而整齐|无序且杂乱	A	无解释
黄花鱼除了能发出叫声外，还能唱出不同的音符，这种说法是_____的。<br>来源：《十万个为什么》（第六版）（上海世纪出版股份有限公司少年儿童出版社2014年版）|正确|错误	A	无解释
所有蜻蜓都具有点水产卵的习性，这种说法是_____的。<br>来源：《十万个为什么》（第六版）（上海世纪出版股份有限公司少年儿童出版社2014年版）|正确|错误	B	无解释
青蛙在咽下食物的时候是闭着眼睛的，这是因为它不忍心吃掉对方。_____<br>来源：《十万个为什么》（第六版）（上海世纪出版股份有限公司少年儿童出版社2014年版）|正确|错误	B	无解释
可以从进食方式分辨毒蛇和无毒蛇，这种说法是_____的。<br>来源：《十万个为什么》（第六版）（上海世纪出版股份有限公司少年儿童出版社 2014年版）|正确|错误	A	无解释
毒蛇头部呈三角形，无毒蛇头部呈椭圆形，只要看蛇头的形状就能判断其有没有毒。<br>来源：《十万个为什么》（第六版）（上海世纪出版股份有限公司少年儿童出版社2014年版）|正确|错误	B	无解释
大部分鱼的身体中都有一种能够控制浮降的特殊构造——“_____”鱼儿就是靠它来上浮和下潜的。<br>来源：《十万个为什么》（第六版)（上海世纪出版股份有限公司少年儿童出版社2014年版）|鱼鳞|鱼鳔	B	无解释
黄花鱼可以用脑袋中的“石头”保持身体平衡，这种说法是_____的。<br>来源：《十万个为什么》（第六版）（上海世纪出版股份有限公司少年儿童出版社2014年版）|正确|错误	A	无解释
下列选项中，把嘴巴当作育婴房的鱼类是_____。<br>来源：《十万个为什么》（第六版）（上海世纪出版股份有限公司少年儿童出版社2014年版）|鲤鱼|龙鱼	B	无解释
下列选项中，_____是热血的鱼，体温可以达到33~35℃。<br>来源：《十万个为什么》（第六版）（上海世纪出版股份有限公司少年儿童出版社2014年版）|鳕鱼|金枪鱼	B	无解释
石首鱼类以善叫而闻名，其声音像碾轧声、打鼓声、蜂雀的飞翔声、猫叫声和呼哨声，其叫声在交配期间特别常见，目的是为了_____。<br>来源：《十万个为什么》（第六版）（上海世纪出版股份有限公司少年儿童出版社2014年版）|觅食|集群	B	无解释
吃鱼翅很滋补，这种说法是_____的。<br>来源：《十万个为什么》（第六版）（上海世纪出版股份有限公司少年儿童出版社2014年版）|正确|错误	B	无解释
萤火虫不仅成虫能发光，卵、幼虫、蛹也都能发光。这种说法是_____的。<br>来源：《十万个为什么》（第六版）（上海世纪出版股份有限公司少年儿童出版社2014年版)|正确|错误	A	无解释
萤火虫依靠发光细胞中的_____来发光，这种反应的发光效率非常高，可达95%。<br>来源：《十万个为什么》（第六版）（上海世纪出版股份有限公司少年儿童出版社2014年版）|物理反应|化学反应	B	无解释
鱼类都是“哑巴”，它们都不会发出声音，这种说法是_____的。<br>来源：《十万个为什么》（第六版）（上海世纪出版股份有限公司少年儿童出版社2014年版）|正确|错误	B	无解释
鱼鳔能帮助鱼在不同深度的水里通过放出或吸进气体，来调节鱼身体的比重。鱼鳔_____了，就会浮上来。<br>来源：《十万个为什么》（第六版）（上海世纪出版股份有限公司少年儿童出版社2014年版）|胀大|缩小	A	无解释
我们在水边看到的“蜻蜓点水”现象，正是蜻蜓成虫的_____行为。<br>来源：《十万个为什么》(第六版）（上海世纪出版股份有限公司少年儿童出版社2014年版）|产卵|捕食	A	无解释
对涉嫌非法集资行为，任何单位和个人    向处置非法集资牵头部门或者其他有关部门举报。|有权|无权	A	无解释
根据《彩票管理条例实施细则》，彩票中奖者应当自开奖之日起60个_____内兑奖。出题：广东省福利彩票发行中心|工作日|自然日	B	无解释
除国家另有规定外，任何单位和个人_____发布包含集资内容的广告或者以其他方式向社会公众进行集资宣传。|可以|不得	B	无解释
除法律、行政法规和国家另有规定外，企业、个体工商户名称和经营范围中_____。包含“金融”“交易所”“交易中心”“理财”“财富管理”“股权众筹”等字样或者内容。<br>出题：中国人民银行黔西南州中心支行|可以|不得	B	无解释
重大国情国力普查所需经费，由_____负担，列入相应年度的财政预算，按时拨付，确保到位。<br>出题：国家统计局|国家统计局|国务院|国务院和地方人民政府共同	C	无解释
《“十四五”软件和信息技术服务业发展规划》指出，鼓励有条件的地区建立信息消费馆、体验中心、公共服务平台，举办信息消费大赛、城市行、体验周等活动。2021年12月19日至21日，2021年全国工业APP和信息消费大赛总决赛在湖南_____举办。|长沙|株洲|湘潭|衡阳	B	无解释
根据《彩票管理条例实施细则》逾期未兑奖的奖金纳入彩票_____，由彩票销售机构结算归集后上缴省级财政，全部留归地方使用。<br>出题：广东省福利彩票发行中心|奖金池|公益金	B	无解释
因参与非法集资受到的损失，由_____自行承担。|集资参与人|非法集资人|非法集资协助人	A	无解释
非法集资人、非法集资协助人不能同时履行所承担的清退集资资金和缴纳罚款义务时，先_____。<br>出题：中国人民银行黔西南州中心支行|缴纳罚款义务|清退集资资金	B	无解释
互联网信息服务提供者应当加强对用户发布信息的管理，_____制作、复制、发布、传播涉嫌非法集资的信息。|可以|不得	B	无解释
经调查认定属于非法集资的，处置非法集资牵头部门应当责令非法集资人、非法集资协助人有关非法活动。|暂时停止|立即停止	B	无解释
根据《彩票管理条例》，彩票发行机构、彩票销售机构、彩票代销者以及其他因职务或者业务便利知悉彩票中奖者个人信息的人员，应当对彩票中奖者个人信息予以_____。|公开|保密	B	无解释